01 01 01 01 01 01 01 01 01 01 01 01 01 01 01 01 01 01 01 01 01 01 01 01 01 01 01 01 01 01 01 01 01 01 01 01 01 01 01 01 01 01 01 01 01 01 01 01 01 01
01 01 01 01 01 01 01 01 01 01 01 01 01 01 01 01 01 01 01 01 01 01 01 01 01 01 01 01 01 04 37 04 01 01 01 01 01 01 01 01 01 01 01 01 01 01 01 01 01 01
01 01 04 04 04 04 04 04 04 04 04 04 04 04 04 04 01 01 01 01 01 01 01 01 01 01 01 01 01 04 04 04 01 01 01 01 01 04 04 04 04 04 04 04 04 04 04 04 04 01
01 01 04 04 04 04 04 04 04 04 04 04 04 04 04 01 01 01 01 04 04 04 04 04 04 01 04 04 04 04 04 04 01 01 01 01 01 04 04 04 04 04 04 04 04 04 04 04 04 01
01 01 01 01 01 01 01 04 04 01 01 01 01 04 04 01 01 01 01 04 04 04 04 04 04 04 04 04 04 04 04 04 01 01 01 01 01 01 04 01 01 01 04 04 01 01 04 04 04 01
01 01 01 01 01 01 01 04 04 01 01 01 01 04 04 01 01 01 01 01 01 04 01 01 01 01 01 01 01 01 01 01 01 01 01 01 01 04 04 01 01 01 04 04 01 01 04 04 04 01
01 01 01 01 01 01 01 04 04 01 01 01 01 04 04 04 04 04 04 04 04 04 04 04 04 04 01 01 01 01 01 01 01 01 01 04 04 04 04 01 01 01 04 04 01 01 01 01 01 01
01 01 01 01 01 01 01 01 01 01 01 01 01 04 04 04 04 04 01 04 04 04 04 04 01 01 01 01 01 01 01 01 01 01 01 04 04 04 04 01 01 01 04 04 01 01 01 01 01 01
01 01 01 01 01 01 01 01 01 01 01 01 01 04 04 01 01 01 01 04 04 04 04 04 01 01 01 01 01 01 01 01 01 01 01 01 01 04 04 01 01 01 04 04 01 01 01 01 01 01
01 01 01 01 01 01 01 01 01 01 01 01 01 04 04 01 01 01 01 04 04 04 04 04 04 04 04 04 04 01 01 01 01 01 01 01 01 04 04 01 01 01 04 04 01 01 01 01 01 01
01 01 01 01 01 01 01 01 01 01 01 01 01 04 04 01 01 01 01 04 04 04 04 04 04 04 04 04 04 01 01 01 01 01 01 01 01 04 04 01 01 01 04 04 01 01 01 01 01 01
01 04 04 04 04 04 04 01 01 01 01 01 01 04 04 01 01 01 01 01 01 01 01 01 01 01 01 04 04 01 01 01 01 01 01 01 01 04 04 01 01 01 04 04 01 01 01 01 01 01
01 04 04 04 04 04 04 04 04 04 04 04 04 04 04 01 01 01 01 01 01 01 01 01 01 01 01 04 04 01 01 01 01 01 01 01 01 04 04 01 01 01 04 04 04 04 01 01 01 01
01 04 04 04 04 04 04 04 04 04 04 04 04 04 04 01 01 01 01 01 01 01 01 01 01 01 01 04 04 04 04 04 04 04 04 01 04 04 04 01 01 01 04 04 04 04 01 01 01 01
01 04 04 04 04 04 04 01 01 01 01 01 01 04 04 01 01 01 04 01 01 01 01 01 01 01 01 04 04 04 04 04 04 04 04 04 04 04 04 01 01 01 01 01 01 01 01 01 01 01
01 04 04 04 04 04 04 01 01 01 01 01 01 04 04 04 04 04 04 04 04 04 04 04 04 04 01 01 01 01 01 01 04 04 01 01 01 04 04 01 01 01 01 01 01 01 01 01 01 01
01 01 01 04 01 01 01 01 01 01 01 01 01 04 04 04 04 04 04 04 04 04 04 04 04 04 01 01 01 01 01 01 04 04 01 01 01 04 04 01 01 01 01 01 01 01 01 04 04 01
01 01 01 04 04 01 01 01 01 01 01 01 01 04 04 04 01 01 04 04 04 01 01 01 04 04 01 01 01 01 01 01 04 04 01 01 01 04 04 01 01 01 01 01 01 01 01 04 04 01
01 01 01 04 04 01 01 01 01 01 01 01 01 04 04 04 01 01 04 04 04 01 01 01 04 04 01 01 01 01 01 01 04 04 01 01 01 04 04 01 01 04 04 01 01 01 01 04 04 01
01 01 01 04 04 01 01 01 01 01 01 01 01 04 04 04 01 01 01 01 01 01 01 01 04 04 01 01 01 04 04 01 04 04 01 01 01 04 04 01 01 04 04 01 01 01 01 04 04 01
01 01 01 04 04 04 04 04 04 04 04 04 04 04 04 04 01 01 01 01 01 01 01 01 04 04 01 01 01 04 04 01 04 04 01 01 01 04 04 04 04 04 04 04 04 04 04 04 04 01
01 01 01 04 04 04 04 04 04 04 04 04 04 04 04 04 01 01 01 01 01 01 01 01 04 04 01 01 01 04 04 04 04 04 01 01 01 04 04 04 04 04 04 04 04 04 04 04 04 01
01 01 01 04 04 01 01 01 01 01 01 01 01 01 04 01 01 01 01 01 04 04 04 04 04 04 01 01 01 04 04 04 04 04 01 01 01 04 04 01 01 01 01 01 01 01 01 04 04 01
01 01 01 04 04 01 01 01 01 01 01 01 01 01 04 04 01 01 01 01 04 04 01 04 04 04 01 01 01 01 01 01 01 01 01 01 01 04 04 01 01 01 01 01 01 01 01 04 04 01
01 01 01 04 04 01 01 01 01 01 01 01 01 01 04 04 01 01 01 01 04 04 01 01 04 04 01 01 01 01 01 01 01 01 01 01 01 04 04 01 01 04 04 04 04 01 01 04 04 01
01 01 01 04 04 01 01 01 01 01 01 01 01 01 04 04 01 01 01 01 04 04 01 01 04 04 01 01 01 01 01 01 01 01 01 01 01 04 04 01 01 04 04 04 04 01 01 04 04 01
01 01 01 04 04 01 01 01 01 01 01 01 01 01 04 04 01 01 01 01 01 01 01 01 04 04 01 01 01 01 01 01 01 01 01 01 01 04 04 04 04 04 04 04 04 04 04 04 04 01
01 01 01 04 04 01 01 01 01 01 01 01 01 01 04 04 01 01 01 01 01 01 01 01 04 04 01 01 01 01 01 01 01 01 01 01 01 04 04 01 01 04 04 04 04 01 01 04 04 01
01 01 01 04 04 01 01 01 01 01 01 01 01 01 04 04 04 04 04 04 04 04 04 04 04 04 01 01 01 01 01 01 01 01 01 01 01 04 04 01 01 04 04 04 04 01 01 04 04 01
01 01 01 04 04 01 01 01 01 01 01 01 01 01 04 04 04 04 04 04 04 04 04 04 04 04 01 01 01 01 01 01 01 01 01 01 01 04 04 01 01 01 01 01 01 01 01 04 04 01
01 01 04 04 04 04 04 04 04 04 01 01 01 01 01 01 01 01 04 04 04 01 01 01 01 01 01 01 01 01 01 01 01 01 01 01 01 04 04 01 01 01 01 01 01 01 01 04 04 01
01 01 04 04 04 04 04 04 04 04 01 01 01 01 01 01 01 01 04 04 04 01 01 01 01 01 01 01 01 01 01 01 01 01 01 01 01 04 04 01 01 01 01 01 01 01 01 04 04 01
01 01 04 04 01 01 01 01 04 04 01 01 01 01 01 01 01 01 01 04 01 01 01 01 01 01 01 01 01 01 01 01 01 01 01 01 01 04 04 04 04 04 04 04 04 04 04 04 04 01
01 01 04 04 01 01 01 01 04 04 01 01 01 01 01 01 01 01 04 04 04 01 01 01 01 01 01 01 01 01 01 01 01 01 01 01 01 04 04 04 04 04 04 04 04 04 04 04 04 01
01 01 04 04 01 01 01 01 04 04 01 01 01 01 01 01 01 04 04 04 04 04 01 01 01 01 01 01 01 01 01 01 01 01 01 01 01 01 01 01 04 04 01 01 01 01 01 01 01 01
01 01 04 04 04 04 01 01 04 04 04 04 04 04 04 04 01 04 04 04 04 04 01 04 04 04 04 04 04 04 04 04 04 04 01 01 01 01 01 01 04 04 01 01 01 01 01 01 01 01
01 01 04 04 04 04 01 01 04 04 04 04 04 04 04 04 04 04 04 04 04 04 04 04 04 04 04 04 04 04 04 04 04 04 01 01 01 01 01 01 04 04 01 01 01 01 01 01 01 01
01 01 01 01 01 01 01 01 04 04 01 01 01 01 01 01 01 04 04 04 04 04 01 01 01 01 04 04 04 01 01 01 04 04 01 01 01 01 01 01 04 04 01 01 01 01 01 01 01 01
01 01 01 01 01 01 01 01 04 04 01 01 01 01 01 01 01 04 04 04 04 04 01 01 01 01 04 04 04 01 01 01 04 04 01 01 01 01 01 01 04 04 01 01 01 01 01 01 01 01
01 01 01 01 01 01 01 01 04 04 01 01 01 01 01 01 01 04 04 04 04 04 01 01 01 01 01 01 01 01 01 01 04 04 01 01 01 01 01 01 04 04 01 01 01 01 01 01 01 01
01 01 01 01 01 01 01 01 04 04 01 01 01 01 01 01 01 04 04 04 04 04 01 01 01 01 01 01 01 01 01 01 04 04 01 01 01 01 01 01 04 04 01 01 01 01 04 04 01 01
01 01 01 01 01 01 01 01 04 04 01 01 01 01 01 01 01 04 04 04 04 04 01 01 01 01 01 01 01 01 01 01 04 04 01 01 01 01 01 01 04 04 01 01 01 01 04 04 01 01
01 01 01 01 01 01 01 01 04 04 01 01 01 01 01 01 01 04 04 36 04 04 01 01 01 01 01 01 01 01 01 01 04 04 01 01 01 01 01 01 01 04 01 01 01 01 04 04 01 01
01 04 04 04 04 04 04 04 04 04 01 01 01 01 01 01 01 01 01 01 01 01 01 01 01 01 01 01 01 01 01 01 04 04 04 04 04 04 04 04 04 04 04 04 04 04 04 04 01 01
01 04 04 04 04 04 04 04 04 04 01 01 01 01 01 01 01 01 01 01 01 01 01 01 01 01 01 01 01 01 01 01 04 04 04 04 04 04 04 04 04 04 04 04 04 04 04 04 01 01
01 01 01 01 01 01 01 01 04 04 01 01 01 01 01 01 01 01 01 01 01 01 01 01 01 04 04 04 01 01 01 01 04 04 01 01 01 01 01 01 01 01 01 01 01 01 04 04 01 01
01 01 01 01 01 01 01 01 04 04 04 04 01 01 01 01 01 01 01 01 01 01 01 01 01 04 04 04 01 01 01 01 04 04 01 01 01 01 01 01 01 01 01 01 01 01 04 04 01 01
01 01 01 01 01 01 01 01 04 04 04 04 01 01 01 01 01 01 01 01 01 01 01 01 01 04 04 04 04 04 04 04 04 04 01 01 01 01 01 01 01 01 01 01 01 01 04 04 01 01
01 01 01 01 01 01 01 01 04 04 04 04 01 01 01 01 01 01 01 01 01 01 01 01 01 04 04 04 04 04 04 04 04 04 01 01 01 01 01 01 01 01 01 01 01 01 01 01 01 01
01 01 01 01 01 01 01 01 01 01 01 01 01 01 01 01 01 01 01 01 01 01 01 01 01 01 01 01 01 01 01 01 01 01 01 01 01 01 01 01 01 01 01 01 01 01 01 01 01 01