03 03 03 03 03 03 03 03 03 03 03 03 03 03 03 03 03 03 03 03 03 03 03 03 03 03 03 03 03 03 03 03 03 03 03 03 03 03 03 03 03 03 03 03 03 03 03 03 03 03
03 03 03 03 03 03 03 03 03 03 03 03 03 03 03 03 03 03 03 03 03 03 03 03 03 03 03 03 03 03 03 03 03 03 03 03 03 03 03 03 03 03 03 03 03 03 03 03 03 03
03 03 03 03 03 03 03 03 03 03 03 03 03 03 03 03 03 03 03 03 03 03 03 03 03 03 03 03 03 03 03 03 03 03 03 03 03 03 03 03 03 03 03 03 03 00 03 03 03 03
03 03 03 03 03 03 03 03 03 03 03 03 03 03 03 03 03 03 03 03 03 03 03 04 04 04 04 04 03 03 03 03 03 03 03 03 03 03 03 03 03 03 03 03 03 00 03 03 03 03
03 03 03 03 03 03 03 03 03 03 03 03 03 03 03 03 03 03 03 03 03 03 03 04 04 04 04 04 03 03 03 03 03 03 03 03 03 03 03 03 03 03 03 03 03 00 03 03 03 03
03 03 03 03 03 03 03 03 04 04 04 04 04 04 04 04 03 03 03 03 03 03 03 04 04 04 04 04 03 03 03 03 03 03 03 03 03 03 03 03 03 03 03 03 03 00 03 03 03 03
03 03 03 03 03 03 03 04 04 03 03 03 03 03 03 04 04 04 04 04 00 04 04 04 04 04 04 04 03 03 03 00 00 00 00 00 00 00 00 00 00 00 00 00 00 00 03 03 03 03
03 03 03 03 03 03 04 04 03 03 03 03 03 03 03 03 03 03 03 04 03 03 03 04 04 04 04 04 03 03 03 00 03 03 03 03 03 03 03 03 03 03 03 03 03 00 03 03 03 03
03 03 03 03 03 03 04 03 03 03 03 03 03 03 03 03 03 03 04 04 03 03 03 04 04 04 04 04 03 03 03 00 03 03 03 03 03 03 03 03 03 03 03 03 00 00 00 03 03 03
03 03 03 03 03 03 04 03 03 03 03 03 03 03 03 03 03 03 03 04 04 03 03 03 03 03 03 03 03 03 03 00 03 03 03 03 03 03 03 03 03 03 03 00 00 00 00 00 03 03
03 03 03 03 03 03 04 04 03 03 03 03 03 03 03 03 03 03 03 03 04 04 03 03 03 03 03 03 03 03 03 00 03 03 03 03 03 03 03 03 03 03 00 00 00 00 00 00 00 03
03 03 03 03 03 03 03 04 03 03 03 03 03 03 03 03 03 03 03 03 03 04 03 03 03 03 03 03 03 03 03 00 03 03 03 03 03 03 03 03 03 03 00 00 00 00 00 00 00 03
03 03 03 03 03 03 03 04 03 03 04 03 03 03 03 03 03 03 03 03 03 04 03 03 03 03 03 03 03 03 03 00 03 03 03 03 03 03 03 03 03 03 00 00 00 00 00 00 00 03
03 03 03 03 03 03 03 04 03 03 04 03 03 03 03 03 03 03 03 03 03 04 03 03 03 03 03 03 03 03 03 00 03 03 03 03 03 03 03 03 03 03 00 00 00 00 00 00 00 03
03 03 03 03 04 04 04 04 04 04 04 03 03 03 03 03 03 03 03 03 03 04 03 03 03 03 03 03 03 03 03 00 03 03 03 03 03 03 03 03 03 03 00 00 00 00 00 00 00 03
03 03 03 03 03 03 03 04 03 03 03 03 03 03 03 03 03 03 03 03 03 04 03 03 03 03 03 03 03 03 03 00 03 03 03 03 03 03 15 03 03 03 03 00 00 00 00 00 03 03
03 03 03 03 03 03 03 04 03 03 03 03 03 03 03 03 03 04 04 04 04 04 04 04 04 04 00 00 00 00 00 00 03 03 03 03 03 03 00 03 03 03 03 03 00 00 00 03 03 03
03 03 03 03 03 03 03 04 03 03 03 03 03 03 03 03 03 04 04 04 04 04 04 04 04 04 03 03 03 03 03 03 03 03 03 03 03 03 00 03 03 03 03 03 00 00 00 03 03 03
03 03 03 03 03 03 03 04 03 03 03 03 03 03 03 03 03 04 04 04 04 04 04 04 04 04 03 03 03 03 03 03 03 03 03 03 03 03 00 00 00 00 00 00 00 00 00 03 03 03
03 03 03 03 03 03 03 03 03 03 03 03 03 03 03 03 03 04 04 04 04 04 04 04 04 04 03 03 03 03 03 03 03 03 03 03 03 03 03 03 03 03 03 03 03 03 03 03 03 03
03 03 03 03 03 03 03 03 03 03 03 03 03 03 03 03 03 04 04 04 04 04 04 04 04 04 03 03 03 03 03 03 03 03 03 03 03 03 03 03 03 03 03 03 03 03 03 03 03 03
03 03 03 03 03 03 03 03 03 03 03 03 03 03 03 03 03 04 04 04 04 04 04 04 04 04 03 03 03 03 03 03 03 03 03 03 03 03 03 03 03 03 03 03 03 03 03 03 03 03
03 03 03 03 03 03 03 03 03 03 03 03 03 03 03 03 03 04 04 04 04 04 04 04 04 04 03 03 03 03 03 03 03 03 03 03 03 03 03 03 03 03 03 03 03 03 03 03 03 03
03 03 03 03 03 03 03 03 03 03 03 03 03 03 03 03 03 03 03 03 04 04 04 03 03 03 03 03 03 03 03 03 03 03 03 03 03 03 03 03 03 03 03 03 03 03 03 03 03 03
03 03 03 03 03 03 03 03 03 03 03 03 03 03 03 03 03 03 03 03 04 04 04 03 03 03 03 03 03 03 03 03 03 03 03 03 03 03 03 03 03 03 03 03 03 03 03 03 03 03
03 03 03 03 03 03 03 03 03 03 03 03 03 03 03 03 03 03 03 03 04 04 04 03 03 03 03 03 03 03 03 03 03 03 03 03 03 03 03 03 03 03 03 03 03 03 03 03 03 03
03 03 03 03 03 03 03 03 03 03 03 03 03 03 03 03 03 03 03 03 04 04 04 03 03 03 03 03 03 03 03 03 03 03 03 03 03 03 03 03 03 03 03 03 03 03 03 03 03 03
03 03 03 03 15 03 03 03 03 03 03 03 03 03 03 03 03 03 03 03 04 04 04 04 04 04 03 03 03 03 03 03 03 03 03 03 03 03 03 03 03 03 03 03 03 03 03 03 03 03
03 03 03 03 00 03 03 03 03 03 03 03 03 03 03 03 03 03 03 03 04 04 04 03 03 03 03 03 03 03 03 03 03 03 03 03 03 03 03 03 03 03 03 03 03 03 03 03 03 03
03 03 03 03 00 03 03 03 03 03 03 03 03 03 03 03 03 03 03 03 04 04 04 03 03 03 03 03 03 03 03 03 03 03 03 03 03 03 03 03 03 03 03 03 03 03 03 03 03 03
03 03 03 03 00 03 03 03 03 03 03 03 03 03 03 03 03 03 03 03 04 04 04 03 03 03 03 03 03 03 03 03 03 03 03 03 03 03 03 03 03 03 03 03 03 03 03 03 03 03
04 04 04 04 04 04 04 04 04 04 04 04 04 04 04 04 04 04 04 04 04 04 04 04 04 04 04 04 04 04 04 04 04 04 04 04 04 04 04 04 04 04 04 04 04 04 04 04 04 04
04 04 04 04 04 04 04 04 04 04 04 04 04 04 04 04 04 04 04 04 04 04 04 04 04 04 04 04 04 04 04 04 04 04 04 04 04 04 04 04 04 04 04 04 04 04 04 04 04 04
04 04 04 04 04 04 04 04 04 04 04 04 04 04 04 04 04 04 04 04 04 04 04 04 04 04 04 04 04 04 04 04 04 04 04 04 04 04 04 04 04 04 04 04 04 04 04 04 04 04
03 03 03 03 03 03 03 03 03 03 03 03 03 03 00 03 03 03 03 03 04 04 04 03 03 03 03 03 03 03 03 03 03 03 04 04 04 03 03 03 03 03 03 03 03 03 03 03 03 03
03 03 03 03 03 03 03 03 03 03 03 03 03 03 04 03 03 03 03 03 04 04 04 03 03 03 03 03 03 03 03 03 03 03 04 04 04 03 03 03 03 03 03 03 03 03 03 03 03 03
03 03 03 03 03 03 03 03 03 03 03 03 03 03 04 03 03 03 03 03 04 04 04 03 03 03 03 03 03 03 03 03 03 03 04 04 04 03 03 03 03 03 03 03 03 03 03 03 03 03
03 03 03 03 03 03 03 03 03 03 03 03 03 04 04 03 03 03 03 03 04 04 04 03 03 03 03 03 02 02 02 02 02 25 30 30 30 24 02 02 02 02 02 03 03 03 03 03 03 03
03 03 03 03 03 03 03 03 03 03 03 03 03 04 03 03 03 03 03 03 04 04 04 03 03 03 03 03 02 02 02 02 02 02 30 34 30 02 11 02 02 02 02 03 03 03 03 03 03 03
03 03 03 03 04 04 04 03 03 03 03 04 04 04 03 03 03 03 03 03 04 04 04 03 03 03 03 03 02 02 02 02 02 31 30 30 30 32 11 11 02 02 02 03 03 03 03 03 03 03
03 03 03 03 04 04 04 03 03 03 03 04 03 03 03 03 03 03 03 03 04 04 04 03 03 03 03 03 02 02 02 02 02 02 30 30 30 02 02 11 11 02 02 03 03 03 03 03 03 03
03 03 03 03 03 00 03 03 03 03 03 04 03 03 03 03 03 03 03 03 04 04 04 03 03 03 03 03 02 02 11 11 02 02 30 30 30 02 02 02 02 02 02 03 03 03 03 03 03 03
03 03 04 04 04 04 04 04 04 03 03 04 03 03 03 03 03 03 03 03 04 04 04 03 03 03 03 03 02 02 02 11 02 02 33 02 33 02 02 02 02 02 02 03 03 03 03 03 03 03
03 03 04 04 04 04 04 04 04 00 04 04 03 03 03 03 03 03 03 03 04 04 04 03 03 03 03 03 02 02 02 02 02 02 02 02 02 02 02 02 02 02 02 03 03 03 03 03 03 03
03 03 04 04 04 04 04 04 04 03 03 03 03 03 03 03 03 03 03 03 04 04 04 03 03 03 03 03 02 02 02 02 02 02 02 02 02 02 11 02 02 02 02 03 03 03 03 03 03 03
03 03 04 04 04 04 04 04 04 03 03 03 03 03 03 03 03 03 03 03 04 04 04 03 03 03 03 03 02 02 02 02 02 02 02 02 02 11 11 02 02 02 02 03 03 03 03 03 03 03
03 03 04 04 04 04 04 04 04 03 03 03 03 03 03 03 03 03 03 03 04 04 04 03 03 03 03 03 02 02 02 02 02 02 02 02 02 02 02 02 02 02 02 03 03 03 03 03 03 03
03 03 04 04 04 04 04 04 04 03 03 03 03 03 03 03 03 03 03 03 04 04 04 03 03 03 03 03 10 10 10 10 10 10 10 10 10 10 10 10 10 10 10 03 03 03 03 03 03 03
03 03 03 03 03 03 03 03 03 03 03 03 03 03 03 03 03 03 03 03 04 04 04 03 03 03 03 03 03 03 03 03 03 03 03 03 03 03 03 03 03 03 03 03 03 03 03 03 03 03
03 03 03 03 03 03 03 03 03 03 03 03 03 03 03 03 03 03 03 03 04 04 04 03 03 03 03 03 03 03 03 03 03 03 03 03 03 03 03 03 03 03 03 03 03 03 03 03 03 03