03 03 03 01 01 01 01 01 03 03 03 03 03 03 03 03 03 03 03 03 03 03 03 03 03 03 03 03 03 03 03 03 03 03 03 03 03 03 03 03 03 03 03 03 03 03 03 03 03 03
03 03 03 01 04 04 04 01 03 03 03 03 03 03 03 03 03 03 03 03 03 03 03 03 03 03 03 03 03 03 03 03 03 03 03 04 04 04 04 04 04 04 04 04 04 04 04 04 04 03
03 03 03 01 04 04 04 01 03 03 03 03 03 03 03 03 03 03 03 03 03 03 03 03 03 03 03 03 03 03 03 03 03 03 03 04 04 04 04 04 04 04 04 04 04 04 04 04 04 03
03 03 03 01 04 04 04 01 03 03 03 03 03 03 03 03 15 03 03 03 03 03 03 03 03 03 03 03 03 03 03 03 03 03 03 04 04 04 04 04 04 04 04 04 04 04 04 04 04 03
03 03 03 01 01 04 01 01 03 03 03 03 03 03 03 03 00 03 03 03 03 03 03 03 03 03 03 03 03 03 03 03 03 03 03 04 04 04 04 04 04 04 04 04 04 04 04 04 04 03
04 04 38 04 04 04 04 04 04 04 04 04 03 03 03 03 00 03 03 03 03 03 03 03 03 03 03 03 03 03 03 03 03 03 03 04 04 04 04 04 04 04 04 04 04 04 04 04 04 03
04 04 04 04 04 04 04 04 04 04 04 04 00 00 00 00 00 03 03 03 03 03 03 03 03 03 03 03 03 03 03 03 03 03 03 04 04 04 04 04 04 04 04 04 04 04 04 04 04 03
04 04 38 04 04 04 04 04 04 04 04 04 03 03 03 03 03 03 03 03 03 03 03 03 03 03 03 03 03 03 03 03 03 03 03 03 03 03 03 03 03 03 03 03 03 03 04 04 04 03
03 03 03 03 03 03 03 03 03 04 04 04 03 03 03 03 03 03 03 03 03 03 03 03 03 03 03 03 03 03 03 03 03 03 03 03 03 03 03 03 03 03 03 03 03 03 03 03 00 03
03 03 03 03 03 03 03 03 03 04 04 04 03 03 03 03 03 03 03 03 03 03 03 03 03 03 03 03 03 03 03 03 03 03 03 03 03 03 03 03 03 03 03 03 03 03 03 03 00 03
03 12 07 07 07 07 07 07 13 04 04 04 00 00 00 00 00 00 00 00 00 00 00 00 00 00 00 00 00 00 00 00 00 00 00 00 00 00 00 00 00 00 00 00 00 00 00 00 00 03
03 08 02 02 02 02 02 02 09 04 04 04 00 00 00 00 00 00 00 00 00 00 00 00 00 00 00 00 00 00 00 00 00 00 00 00 00 00 00 00 00 00 00 00 00 00 00 00 00 03
03 08 02 02 02 02 02 02 09 04 04 04 00 00 00 00 00 00 00 00 00 00 00 00 00 00 00 00 00 00 00 00 00 00 00 00 00 00 00 00 00 00 00 00 00 12 07 07 07 07
03 08 02 11 02 02 02 02 09 04 04 04 00 00 00 00 00 00 00 00 00 00 00 00 00 00 00 00 00 00 00 00 00 00 00 00 00 00 00 00 00 00 00 12 07 24 02 02 02 02
03 14 10 10 10 10 10 10 18 04 04 04 00 00 00 00 00 00 00 00 00 00 00 00 00 00 00 00 00 00 00 00 00 00 00 00 00 00 00 00 00 00 12 24 02 02 02 02 02 02
03 00 00 00 00 00 00 00 00 04 04 04 00 00 00 00 00 00 00 00 00 00 00 00 00 00 00 00 00 00 00 00 00 00 00 00 00 00 00 00 00 12 24 02 02 02 02 02 02 02
07 07 07 07 07 07 07 07 01 04 04 04 01 07 07 07 07 07 07 07 07 07 07 07 07 07 07 07 07 07 07 07 07 07 07 07 07 07 07 07 07 24 02 02 02 02 27 10 10 10
02 02 02 02 02 02 02 02 01 04 04 04 01 02 02 02 02 02 02 02 02 02 02 02 02 02 02 02 02 02 02 02 02 02 02 02 11 02 02 02 02 02 02 11 02 27 18 00 00 03
02 02 02 02 11 11 11 02 01 04 04 04 01 02 02 02 02 02 02 02 02 11 02 02 02 02 02 02 02 02 02 11 02 02 11 02 11 02 02 02 02 02 02 27 10 18 00 00 00 03
02 02 02 02 02 02 02 02 01 04 04 04 01 02 02 02 02 02 11 02 02 02 02 02 02 02 02 02 02 02 02 02 02 02 11 02 02 11 02 02 02 11 27 18 00 00 00 00 00 03
10 10 10 10 10 10 10 10 01 04 04 04 01 10 10 10 10 10 10 10 10 10 10 10 10 10 10 10 10 10 10 10 10 10 10 10 10 10 10 10 10 10 18 00 00 00 00 00 00 03
03 00 00 00 00 00 00 00 03 04 04 04 03 00 00 00 00 00 00 00 00 00 00 00 00 00 00 00 00 00 00 00 00 00 00 00 00 00 00 00 00 00 00 00 00 00 00 00 00 03
03 00 00 00 00 00 00 00 03 04 04 04 03 00 00 00 00 00 00 00 00 00 00 00 00 00 01 01 01 01 01 01 01 01 01 01 01 00 00 00 00 00 00 00 00 00 00 00 00 03
03 00 00 00 00 00 00 00 03 04 04 04 03 00 00 00 00 00 00 00 00 00 00 00 00 00 01 01 01 01 01 01 01 01 01 01 01 00 00 00 00 00 00 00 00 00 00 00 00 03
03 00 00 00 00 00 00 00 03 04 04 04 03 00 00 00 00 00 00 00 00 00 00 00 00 00 01 01 01 01 01 01 01 01 01 01 01 00 00 00 00 00 00 00 00 00 00 00 00 03
03 00 00 00 00 00 00 00 03 04 04 04 03 00 00 00 00 00 00 00 00 00 00 00 00 00 01 01 01 01 01 01 01 01 01 01 01 00 00 00 00 00 00 00 00 00 00 00 00 03
03 00 00 00 00 00 00 00 03 04 04 04 03 00 00 00 00 00 00 00 00 00 00 00 00 00 01 01 01 01 01 01 01 01 01 01 01 00 00 00 00 00 00 00 00 00 00 00 00 03
03 00 00 00 00 00 00 00 03 04 04 04 03 00 00 00 00 00 00 00 00 00 00 00 00 00 01 01 01 01 01 01 01 01 01 01 01 00 00 00 00 00 00 00 00 00 00 00 00 03
03 00 00 00 00 00 00 00 03 04 04 04 03 00 00 00 00 00 00 00 00 00 00 00 00 00 01 01 01 01 06 19 06 01 01 01 01 00 00 00 00 00 00 00 00 00 00 00 00 03
03 00 00 00 00 00 00 00 03 04 04 04 03 00 00 00 00 00 00 00 00 00 00 00 00 00 00 00 00 03 04 04 04 03 00 00 00 00 00 00 00 00 00 00 00 00 00 00 00 03
03 03 03 03 03 03 03 03 03 04 04 04 03 03 03 03 03 03 03 03 03 03 03 03 03 03 03 03 03 03 04 04 04 03 03 03 03 03 03 03 03 03 03 03 03 03 03 03 03 03
03 03 03 03 03 03 03 03 03 04 04 04 04 04 04 38 04 04 04 04 04 04 04 04 04 04 04 04 04 04 04 04 04 04 04 04 04 04 04 04 04 04 04 04 04 04 04 04 04 04
03 03 03 03 03 03 03 03 03 04 04 04 04 04 04 04 04 04 04 04 04 04 04 04 04 04 04 04 04 04 04 04 04 04 04 04 04 04 04 04 04 04 04 04 04 04 04 04 04 04
03 03 03 03 03 03 03 03 03 04 04 04 04 04 04 38 04 04 04 04 04 04 04 04 04 04 04 04 04 04 04 04 04 04 04 04 04 04 04 04 04 04 04 04 04 04 04 04 04 04
03 03 03 03 03 03 03 03 03 03 04 04 04 04 04 03 03 03 03 03 03 03 03 03 00 03 03 03 03 03 03 03 03 03 04 03 03 03 03 03 03 03 03 03 03 03 03 03 03 03
03 03 03 03 03 03 03 03 03 03 04 04 04 04 04 03 04 04 03 03 03 04 04 04 04 03 03 03 03 03 03 03 03 03 04 03 03 03 03 03 03 03 03 03 03 03 03 03 03 03
03 03 03 03 03 03 03 03 03 03 04 04 04 04 04 03 04 04 03 03 03 04 03 03 03 03 03 03 03 03 03 03 03 03 04 03 03 03 03 03 03 03 03 03 03 03 03 03 03 03
03 03 03 03 03 03 03 04 04 04 04 04 04 04 04 03 03 04 03 03 03 04 03 03 03 03 03 03 03 03 03 03 03 03 04 03 03 03 03 03 03 03 03 03 03 03 03 03 03 03
03 03 03 03 03 03 03 03 03 03 04 04 04 04 04 03 03 04 03 03 03 04 03 03 03 03 03 03 03 03 03 03 03 03 04 03 03 03 03 03 03 03 03 03 03 03 03 03 03 03
03 03 03 03 03 03 03 03 03 03 04 04 04 04 04 03 03 04 04 04 04 04 04 04 04 03 03 03 03 03 03 03 03 03 04 03 03 03 03 03 03 03 03 03 03 03 03 03 03 03
03 03 03 03 03 03 04 04 04 04 04 04 04 04 04 03 03 03 03 03 03 04 03 03 03 03 03 03 03 03 03 03 03 03 04 03 03 03 03 03 03 03 03 03 03 03 03 03 03 03
03 03 03 03 03 03 04 03 03 03 04 04 04 04 04 03 03 03 03 03 03 04 03 03 03 03 03 01 06 01 06 01 06 01 04 01 01 01 01 01 01 01 01 01 01 01 01 01 01 01
03 03 03 03 03 03 04 03 03 03 04 04 04 04 04 04 04 04 04 04 04 04 03 03 03 03 03 01 04 04 04 04 04 04 04 01 01 01 01 01 01 01 04 04 04 01 01 01 01 01
03 03 03 03 03 03 04 03 03 03 04 04 04 04 04 03 03 03 03 03 03 04 03 03 03 03 03 01 04 04 04 04 04 04 04 01 01 01 01 01 01 01 04 04 04 01 01 01 01 01
03 03 03 03 03 03 04 03 03 03 04 04 04 04 04 03 03 03 03 03 03 04 03 03 03 03 03 01 04 04 04 04 04 04 04 01 01 06 19 06 01 01 04 04 04 01 06 19 06 01
03 03 03 03 03 03 04 04 04 04 04 04 04 04 04 04 04 04 03 03 03 04 03 03 03 03 03 01 04 04 04 04 04 04 04 04 04 04 04 04 04 04 04 04 04 04 04 04 04 01
03 03 03 03 03 03 03 03 03 03 04 04 04 04 04 03 03 03 03 03 03 04 04 04 04 03 03 01 04 04 04 04 04 04 04 04 04 04 04 04 04 04 04 04 04 04 04 04 04 01
03 03 03 03 03 03 03 03 03 03 04 04 04 04 04 03 03 03 03 03 03 04 04 04 04 03 03 01 04 04 04 04 04 04 04 04 04 04 04 04 04 04 04 04 04 04 04 04 04 01
03 03 03 03 03 03 03 03 04 04 04 04 04 04 04 04 04 03 03 03 03 04 04 04 04 03 03 01 04 04 04 04 04 04 04 04 04 04 04 04 04 04 04 04 04 04 04 04 04 01
03 03 03 03 03 03 03 03 03 03 03 03 03 03 03 03 03 03 03 03 03 03 03 03 03 03 03 01 01 01 01 01 01 01 01 01 01 01 01 01 01 01 01 01 01 01 01 01 01 01