01 01 01 01 01 01 01 01 01 01 01 01 01 01 01 02 02 02 02 03 03 03 03 03 03 03 03 03 03 03 03 03 03 03 03 03 03 03 03 03 03 03 03 03 03 03 03 03 03 03
01 04 04 01 01 01 01 01 04 04 01 01 01 04 01 02 02 02 02 03 03 03 03 03 03 03 03 03 03 03 03 03 03 03 03 03 03 03 03 03 03 03 03 03 03 03 03 03 03 03
01 04 04 01 01 01 01 01 04 04 01 01 01 04 01 02 02 02 02 03 03 03 03 03 03 03 03 03 03 03 03 03 03 03 03 03 03 03 03 03 03 03 03 03 03 03 03 03 03 03
01 04 04 01 06 04 06 01 04 04 06 04 06 04 01 02 02 02 02 03 03 03 03 03 03 03 03 03 03 03 03 03 03 03 03 03 03 03 03 03 03 03 03 03 03 03 03 03 03 03
01 04 04 04 04 04 04 04 04 04 04 04 04 04 01 01 01 01 01 01 03 03 03 03 03 03 03 03 03 03 03 03 03 03 03 03 03 03 03 03 03 03 03 03 03 03 03 03 03 03
01 04 04 04 04 04 04 04 04 04 04 04 04 04 04 04 04 04 04 04 04 04 04 04 04 04 04 04 04 04 04 04 04 04 04 04 04 04 04 04 04 04 04 04 04 04 04 04 04 04
01 04 04 04 04 04 04 04 04 04 04 04 04 04 04 04 04 04 04 04 04 04 04 04 04 04 04 04 04 04 04 04 04 04 04 04 04 04 04 04 04 04 04 04 04 04 04 04 04 04
01 04 04 04 04 04 04 04 04 04 04 04 04 04 04 04 04 04 04 04 04 04 04 04 04 04 04 04 04 04 04 04 04 04 04 04 04 04 04 04 04 04 04 04 04 04 04 04 04 04
01 01 01 01 01 01 06 04 04 04 06 01 01 01 01 01 01 01 01 01 03 03 03 03 03 03 03 03 03 03 03 03 04 04 04 03 03 03 03 03 03 03 03 03 03 03 03 03 03 03
03 03 03 03 03 03 03 04 04 04 03 03 03 03 03 02 02 02 02 03 03 03 03 03 03 03 03 03 03 03 03 03 04 04 04 03 03 03 03 03 03 03 15 03 03 03 03 03 03 03
03 03 03 03 03 03 03 04 04 04 03 03 03 03 03 02 02 02 02 03 03 03 03 03 03 03 03 03 03 03 03 03 04 04 04 03 03 03 03 03 03 00 00 00 03 03 03 03 03 03
03 03 03 03 03 03 03 03 03 03 03 03 03 03 03 02 02 02 02 03 03 03 03 03 03 03 03 03 03 03 03 03 04 04 04 03 03 03 03 03 03 00 00 00 03 03 03 03 03 03
03 03 03 03 03 03 03 03 03 03 03 03 03 03 03 02 02 02 02 03 03 03 03 03 03 03 03 03 03 03 03 03 04 04 04 03 03 03 03 03 03 03 00 03 03 03 03 03 03 03
03 03 03 03 03 03 03 03 03 03 03 03 03 03 03 02 02 02 02 03 03 03 03 03 03 03 03 03 03 03 03 03 04 04 04 03 03 03 03 03 00 00 00 00 00 03 03 03 03 03
03 03 03 03 03 03 03 03 03 03 03 03 03 03 03 02 02 02 02 03 03 03 03 03 03 03 03 03 03 03 03 03 04 04 04 03 03 03 03 00 00 00 00 00 00 00 03 03 03 03
03 03 03 03 03 03 03 03 03 03 03 03 03 03 03 02 02 02 02 03 03 03 03 03 03 03 03 03 03 03 03 03 04 04 04 03 03 03 03 00 00 00 00 00 00 00 03 03 03 03
03 03 03 03 03 03 03 03 03 03 03 03 03 03 03 02 02 02 02 03 03 03 03 03 03 03 03 03 03 03 03 03 04 04 04 03 03 03 03 00 00 00 00 00 00 00 03 03 03 03
03 03 03 03 03 03 03 03 03 03 03 03 03 03 03 02 02 02 02 03 03 03 03 03 03 03 03 03 03 03 03 03 04 04 04 03 03 03 03 00 00 00 00 00 00 00 03 03 03 03
03 03 03 03 03 03 03 03 03 03 03 03 03 03 03 02 02 02 02 03 03 03 03 03 03 03 03 03 03 03 03 03 04 04 04 03 03 03 03 03 00 00 00 00 00 03 03 03 03 03
03 03 03 03 03 03 03 03 03 03 03 03 03 03 03 02 02 02 02 03 03 03 03 03 03 03 03 03 03 03 03 03 04 04 04 03 03 03 03 03 03 03 00 03 03 03 03 03 03 03
03 03 03 03 03 03 03 03 03 03 03 03 03 03 03 02 02 02 02 03 03 03 03 03 03 03 03 03 03 03 03 03 04 04 04 03 03 03 03 03 03 03 00 03 03 03 03 03 03 03
03 03 03 03 03 03 03 03 03 03 03 03 03 03 03 02 02 02 02 03 03 03 03 03 03 03 03 03 03 03 03 03 04 04 04 03 03 03 03 03 03 03 00 03 03 03 03 03 03 03
03 03 03 03 03 03 03 03 03 03 03 03 03 03 03 02 02 02 02 03 03 03 03 03 03 03 03 03 03 03 03 03 04 04 04 00 00 00 00 00 00 00 00 03 03 03 03 03 03 03
03 03 03 03 03 03 03 03 03 03 03 03 03 03 03 02 02 02 02 03 03 03 03 03 03 03 03 03 03 03 03 03 04 04 04 03 03 03 03 03 03 03 03 03 03 03 03 03 03 03
03 03 03 03 03 03 03 03 03 03 03 03 03 03 03 02 02 02 02 03 03 03 03 03 03 03 03 03 03 03 03 03 04 04 04 03 03 03 03 03 03 03 03 03 03 03 03 03 03 03
03 03 03 03 03 03 03 03 03 03 03 03 03 03 03 02 02 02 02 03 03 03 03 03 03 03 03 03 03 03 03 03 04 04 04 03 03 03 03 03 03 03 03 03 03 03 03 03 03 03
03 03 03 03 03 03 03 03 03 03 03 03 03 03 03 02 02 02 02 03 03 03 03 03 03 03 03 03 03 04 04 04 04 04 04 03 03 03 03 03 03 03 03 03 03 03 03 03 03 03
03 03 03 03 03 03 03 03 03 03 03 03 03 03 03 02 02 02 02 03 03 03 03 03 03 03 03 03 03 03 03 03 04 04 04 03 03 03 03 03 03 03 03 03 03 03 03 03 03 03
03 03 03 03 03 03 03 03 03 03 03 03 03 03 03 02 02 02 02 00 00 00 00 00 00 00 00 00 00 00 03 03 04 04 04 03 03 03 03 03 03 03 03 03 03 03 03 03 03 03
03 03 03 03 03 03 03 03 03 03 03 03 03 03 03 02 02 02 02 00 00 00 00 00 00 00 00 00 00 00 00 03 04 04 04 03 03 03 03 03 03 03 03 03 03 03 03 03 03 03
03 03 03 03 03 03 03 03 03 03 03 03 03 00 03 02 02 02 02 00 00 00 00 00 00 00 00 00 00 00 00 00 04 04 04 03 03 03 03 03 03 03 03 03 03 03 03 03 03 03
03 03 03 03 03 03 03 03 03 03 03 03 03 00 03 02 02 02 02 00 00 00 00 00 00 00 00 00 00 00 00 00 04 04 04 03 03 03 03 03 03 03 03 03 03 03 03 03 03 03
03 03 03 03 03 03 03 03 03 03 03 03 03 00 03 02 02 02 02 00 00 00 00 00 00 00 00 00 00 00 00 00 04 04 04 03 03 03 03 03 03 03 03 03 03 03 03 03 03 03
03 03 03 03 03 03 03 03 03 03 03 03 03 00 03 02 02 02 02 00 00 00 00 00 00 00 00 00 00 00 00 00 04 04 04 03 03 03 03 03 03 03 03 03 03 03 03 03 03 03
03 03 03 03 03 03 03 03 03 03 03 03 03 00 03 02 02 02 02 00 00 00 00 00 00 00 00 00 00 00 00 00 04 04 04 03 03 03 03 03 03 03 03 03 03 03 03 03 03 03
03 03 03 03 03 01 01 01 01 01 00 00 00 00 00 02 02 02 02 00 00 00 00 00 00 00 00 00 00 00 00 00 04 04 04 03 03 03 03 03 03 03 03 03 03 03 03 03 03 03
03 03 03 03 03 01 04 04 04 01 00 00 00 00 00 02 02 02 02 00 00 00 00 00 00 00 00 00 00 00 00 00 04 04 04 03 03 03 03 03 03 03 03 03 03 03 03 03 03 03
03 03 03 03 03 01 04 04 04 01 00 00 00 00 00 02 02 02 02 00 00 00 00 00 00 00 00 00 00 00 00 00 04 04 04 03 03 03 03 03 03 03 03 03 03 03 03 03 03 03
03 03 03 03 03 01 04 04 04 01 00 00 00 00 00 02 02 02 02 00 00 00 00 00 00 00 00 00 00 00 00 00 04 04 04 04 04 04 04 03 03 03 03 03 03 03 03 03 03 03
03 03 03 03 03 01 01 04 01 01 00 00 00 00 01 01 01 01 01 01 00 00 00 00 00 00 00 00 00 00 00 00 04 04 04 03 03 03 04 03 03 03 03 03 03 03 03 03 03 03
03 03 03 03 03 04 04 04 04 04 04 04 04 04 04 04 04 04 04 04 04 04 04 04 04 04 04 04 04 04 04 04 04 04 04 03 03 03 04 03 03 03 03 03 03 03 04 04 04 03
03 03 03 03 03 04 04 04 04 04 04 04 04 04 04 04 04 04 04 04 04 04 04 04 04 04 04 04 04 04 04 04 04 04 04 03 03 03 04 03 03 03 03 03 03 03 04 04 04 03
03 03 03 03 03 04 04 04 04 04 04 04 04 04 04 04 04 04 04 04 04 04 04 04 04 04 04 04 04 04 04 04 04 04 04 03 03 03 04 03 03 03 03 03 03 03 04 04 04 03
03 03 03 03 03 03 03 03 03 03 03 04 03 03 01 01 01 01 01 01 03 03 03 03 03 03 03 03 03 03 03 03 03 03 03 03 03 03 04 03 03 03 03 03 03 03 03 04 03 03
03 03 03 04 04 04 04 04 04 04 04 04 04 04 04 02 02 02 02 03 03 03 03 03 03 03 03 03 03 03 03 03 03 03 03 03 03 03 04 03 03 03 03 03 03 03 03 04 03 03
03 03 03 04 04 04 04 04 04 04 04 04 04 04 04 02 02 02 02 03 03 03 03 03 03 03 03 03 03 03 03 03 03 03 03 03 03 03 04 03 03 03 03 03 03 03 03 04 03 03
03 03 03 04 04 04 04 04 04 04 04 04 04 04 04 02 02 02 02 03 03 03 03 03 03 03 03 03 03 03 03 03 03 03 03 03 03 03 04 04 04 04 04 04 04 04 04 04 03 03
03 03 03 04 04 04 04 04 04 04 04 04 04 04 04 02 02 02 02 03 03 03 03 03 03 03 03 03 03 03 03 03 03 03 03 03 03 03 03 03 03 03 03 03 03 03 03 03 03 03
03 03 03 04 04 04 04 04 04 04 04 04 04 04 04 02 02 02 02 03 03 03 03 03 03 03 03 03 03 03 03 03 03 03 03 03 03 03 03 03 03 03 03 03 03 03 03 03 03 03
03 03 03 03 03 03 03 03 03 03 03 03 03 03 03 02 02 02 02 03 03 03 03 03 03 03 03 03 03 03 03 03 03 03 03 03 03 03 03 03 03 03 03 03 03 03 03 03 03 03