03 03 03 03 08 02 02 02 09 03 03 03 03 03 03 01 01 01 01 23 01 01 01 01 03 03 03 03 03 03 03 03 03 03 03 03 03 03 03 03 03 03 03 03 03 03 03 03 03 03
03 03 03 03 08 02 02 02 09 00 00 00 00 00 00 00 00 00 04 04 04 00 00 00 00 00 03 03 03 03 03 03 03 03 03 03 03 03 03 03 03 03 03 03 03 03 03 03 03 03
03 03 03 03 08 02 02 02 09 00 00 00 00 00 00 00 00 00 04 04 04 00 00 00 00 00 04 04 04 04 04 03 03 03 03 03 03 03 03 03 03 03 03 03 03 03 03 03 03 03
03 03 03 03 08 11 02 02 25 13 00 00 00 00 00 00 00 00 04 04 04 00 00 00 00 00 03 03 03 03 04 04 04 04 04 04 03 03 04 04 04 03 03 03 03 03 03 03 03 03
03 03 03 03 14 10 02 11 02 25 07 07 07 07 07 07 07 01 04 04 04 01 07 07 07 07 07 07 13 03 03 03 04 03 03 04 04 04 04 04 04 03 03 03 03 03 03 03 03 03
03 03 03 03 03 03 26 02 02 02 02 02 02 02 02 02 02 01 04 04 04 01 02 02 02 02 02 02 25 13 03 03 04 03 03 03 03 03 04 04 04 03 03 03 03 03 03 03 03 03
03 03 04 03 03 03 14 26 02 02 11 02 02 02 11 02 02 01 04 04 04 01 02 02 11 02 02 02 02 25 07 13 04 03 03 03 03 03 03 04 04 03 03 03 03 03 03 03 03 03
03 03 04 03 03 03 03 14 26 02 02 02 02 02 02 11 02 01 04 04 04 01 02 02 02 02 02 02 11 02 02 25 07 13 03 03 03 03 03 04 04 03 03 03 03 03 03 03 03 03
03 03 04 04 04 04 03 03 14 10 10 10 10 10 10 10 10 01 04 04 04 01 10 10 10 10 10 26 02 02 02 02 02 25 13 03 03 03 03 04 04 03 03 03 03 03 03 03 03 03
03 03 04 04 04 04 03 03 03 03 03 03 03 03 03 03 03 03 04 04 04 03 03 03 03 03 03 14 26 02 02 02 02 02 09 03 03 03 03 03 03 03 03 03 03 03 03 03 03 03
03 03 04 04 04 04 03 03 03 03 03 03 03 03 03 03 03 03 04 04 04 03 03 03 03 03 03 03 14 10 26 02 02 02 25 13 03 03 03 03 03 03 03 03 03 03 03 03 03 03
03 03 04 04 04 04 03 03 03 03 03 03 03 03 03 03 03 03 04 04 04 03 03 03 03 03 03 03 03 03 14 26 02 11 02 09 03 03 03 03 03 03 03 03 03 03 03 03 03 03
03 03 04 04 04 04 03 03 03 03 03 03 03 03 03 03 03 03 04 04 04 03 03 03 03 03 03 03 03 03 03 14 26 02 02 25 13 03 03 03 03 03 03 03 03 03 03 03 03 03
03 03 04 04 04 04 03 03 03 03 03 03 03 03 03 03 03 03 04 04 04 03 03 03 03 03 03 03 03 03 03 03 14 26 02 02 25 07 13 03 03 03 03 03 03 03 03 03 03 03
03 03 03 03 03 04 03 03 03 03 03 03 03 03 03 03 03 03 04 04 04 03 03 03 03 03 03 03 03 03 03 03 03 14 26 02 02 02 25 13 03 03 03 03 03 03 03 03 03 03
03 03 03 03 03 04 03 03 03 03 03 03 03 03 03 03 03 03 04 04 04 03 03 03 03 03 03 03 03 03 03 03 03 03 14 26 02 11 02 25 13 03 03 03 03 03 03 03 03 03
03 03 03 03 03 04 03 03 04 03 03 03 03 03 03 03 03 03 04 04 04 03 03 03 03 03 03 03 03 03 03 03 03 03 03 14 26 02 02 02 25 13 03 03 03 03 03 03 03 03
03 03 03 03 03 04 03 03 04 03 03 03 03 03 03 03 03 03 04 04 04 03 03 03 03 03 03 03 03 03 03 03 03 03 03 03 14 26 02 02 02 25 13 03 03 03 03 03 03 03
03 03 03 03 03 04 04 04 04 04 04 04 03 03 03 03 03 03 04 04 04 03 03 03 03 03 03 03 03 03 03 03 03 03 03 03 03 14 26 02 02 02 25 13 03 03 03 03 03 03
03 03 03 03 03 03 03 03 04 03 03 03 03 03 03 03 03 03 04 04 04 03 03 03 03 03 03 03 03 03 03 03 03 03 03 03 03 03 14 26 02 11 02 25 13 03 03 03 03 03
03 03 03 03 03 03 03 03 04 03 03 03 03 03 03 03 03 03 04 04 04 03 03 03 03 03 03 03 03 03 03 03 03 03 03 03 03 03 03 14 26 02 02 02 25 13 03 03 03 03
03 03 03 03 03 03 03 03 04 03 03 03 03 03 03 03 03 03 04 04 04 03 03 03 03 03 03 03 03 03 03 03 03 03 03 03 03 03 03 03 14 26 02 02 02 25 07 07 07 07
03 03 03 04 04 04 04 04 04 04 04 04 04 04 03 03 03 03 04 04 04 03 03 03 03 03 03 01 01 01 01 01 01 01 01 01 03 03 03 03 03 14 26 02 02 11 02 02 02 11
03 03 03 04 04 04 04 04 04 04 04 04 04 04 03 03 03 03 04 04 04 03 03 03 03 03 03 01 01 01 01 01 01 01 01 01 03 03 03 03 03 03 14 26 02 02 02 02 02 02
03 03 03 04 04 04 04 04 04 04 04 04 04 04 03 03 03 03 04 04 04 03 03 03 03 03 03 01 01 01 01 01 01 01 01 01 03 03 03 03 03 03 03 14 10 26 02 02 02 02
03 03 03 04 04 04 04 04 04 04 04 04 04 04 03 03 03 03 04 04 04 03 03 03 03 03 03 01 01 01 01 01 01 01 01 01 03 03 03 03 03 03 03 03 03 14 10 10 10 10
03 03 03 04 04 04 04 04 04 04 04 04 04 04 03 03 03 03 04 04 04 03 03 03 03 03 03 01 01 01 01 01 01 01 01 01 03 03 03 03 03 03 03 03 03 03 03 03 03 03
03 03 03 04 04 04 04 04 04 04 04 04 04 04 03 03 03 03 04 04 04 03 03 03 03 03 03 01 01 01 06 19 06 01 01 01 03 03 03 03 03 03 03 03 03 03 03 03 03 03
03 03 03 04 04 04 04 04 04 04 04 04 04 04 03 03 03 03 04 04 04 03 03 03 03 03 03 03 03 03 04 04 04 03 03 03 03 03 03 03 03 03 03 03 03 03 03 03 03 03
03 03 03 03 03 03 03 04 04 04 03 03 03 03 03 03 03 03 04 04 04 03 03 03 03 03 03 03 03 03 04 04 04 03 03 03 03 03 03 03 03 03 03 03 03 03 03 03 03 03
03 03 03 03 03 03 03 04 04 04 03 03 03 03 03 03 03 03 04 04 04 03 03 03 03 03 03 03 03 03 04 04 04 03 03 03 03 03 03 03 03 03 03 03 03 03 03 03 03 03
04 04 04 04 04 04 04 04 04 04 04 04 04 04 04 04 04 04 04 04 04 04 04 04 04 04 04 04 04 04 04 04 04 03 03 03 03 03 03 03 03 03 03 03 03 03 03 03 03 03
04 04 04 04 04 04 04 04 04 04 04 04 04 04 04 04 04 04 04 04 04 04 04 04 04 04 04 04 04 04 04 04 04 03 03 03 03 03 03 03 03 03 03 03 03 03 03 03 03 03
04 04 04 04 04 04 04 04 04 04 04 04 04 04 04 04 04 04 04 04 04 04 04 04 04 04 04 04 04 04 04 04 04 03 03 03 03 03 03 03 03 03 03 03 03 03 03 03 03 03
03 03 03 03 03 03 03 03 03 03 03 03 03 03 03 03 03 03 03 03 03 03 03 03 03 03 03 03 03 03 03 03 03 03 03 03 03 03 03 03 03 03 03 03 03 03 03 03 03 03
03 03 03 03 03 03 03 03 03 03 03 03 03 03 03 03 03 03 03 03 03 03 03 03 03 03 03 03 03 03 03 03 03 03 03 03 03 03 03 03 03 03 03 03 03 03 03 03 03 03
03 03 03 03 03 03 03 03 03 03 03 03 03 03 03 03 03 03 03 03 03 03 03 03 03 03 03 03 03 03 03 03 03 03 03 03 03 03 03 03 03 03 03 03 03 03 03 03 03 03
03 03 03 03 03 03 03 03 03 03 03 03 03 03 03 03 03 03 03 03 03 03 03 03 03 03 03 03 03 03 03 03 03 03 03 03 03 03 03 03 03 03 03 03 03 03 03 03 03 03
03 03 03 03 03 03 03 03 03 03 03 03 03 03 03 03 03 03 03 03 03 03 03 03 03 03 03 03 03 03 03 03 03 03 03 03 03 03 03 03 03 03 03 03 03 03 03 03 03 03
03 03 03 03 03 03 03 03 03 03 03 03 03 03 03 03 03 03 03 03 03 03 03 03 03 03 03 03 03 03 03 03 03 03 03 03 03 03 03 03 03 03 03 03 03 03 03 03 03 03
03 03 03 03 03 03 03 03 03 03 03 03 03 03 03 03 03 03 03 03 03 03 03 03 03 03 03 03 03 03 03 03 03 03 03 03 03 03 03 03 03 03 03 03 03 03 03 03 03 03
03 03 03 03 03 03 03 03 03 03 03 03 03 03 03 03 03 03 03 03 03 03 03 03 03 03 03 03 03 03 03 03 03 03 03 03 03 03 03 03 03 03 03 03 03 03 03 03 03 03
03 03 03 03 03 03 03 03 03 03 03 03 03 03 03 03 03 03 03 03 03 03 03 03 03 03 03 03 03 03 03 03 03 03 03 03 03 03 03 03 03 03 03 03 03 03 03 03 03 03
03 03 03 03 03 03 03 03 03 03 03 03 03 03 03 03 03 03 03 03 03 03 03 03 03 03 03 03 03 03 03 03 03 03 03 03 03 03 03 03 03 03 03 03 03 03 03 03 03 03
03 03 03 03 03 03 03 03 03 03 03 03 03 03 03 03 03 03 03 03 03 03 03 03 03 03 03 03 03 03 03 03 03 03 03 03 03 03 03 03 03 03 03 03 03 03 03 03 03 03
03 03 03 03 03 03 03 03 03 03 03 03 03 03 03 03 03 03 03 03 03 03 03 03 03 03 03 03 03 03 03 03 03 03 03 03 03 03 03 03 03 03 03 03 03 03 03 03 03 03
03 03 03 03 03 03 03 03 03 03 03 03 03 03 03 03 03 03 03 03 03 03 03 03 03 03 03 03 03 03 03 03 03 03 03 03 03 03 03 03 03 03 03 03 03 03 03 03 03 03
03 03 03 03 03 03 03 03 03 03 03 03 03 03 03 03 03 03 03 03 03 03 03 03 03 03 03 03 03 03 03 03 03 03 03 03 03 03 03 03 03 03 03 03 03 03 03 03 03 03
03 03 03 03 03 03 03 03 03 03 03 03 03 03 03 03 03 03 03 03 03 03 03 03 03 03 03 03 03 03 03 03 03 03 03 03 03 03 03 03 03 03 03 03 03 03 03 03 03 03
03 03 03 03 03 03 03 03 03 03 03 03 03 03 03 03 03 03 03 03 03 03 03 03 03 03 03 03 03 03 03 03 03 03 03 03 03 03 03 03 03 03 03 03 03 03 03 03 03 03